Sokoban,2
###################
#o #  #  #  #  # o#
#                 #
#                 #
#                 #
###             ###
#A   @       @    #
#                 #
###################