Sokoban,1
#######################
#                     #
#                     #
# o@ A                #
#                     #
#                 #####
#######################